Hello my	friend this is	just a text	file. Exactly
as	you
expected isn't	it? Just
some
text and any	hidden	message inside.
So	you can leave	since this	text
isn't that	interesting. Oh
my
god why are	you	still reading
this	won't you just	leave this	file?
Please do	it.	JUST DO
IT.
You can't	imagin how
annoying	it
is to	 hit
the right
arrow key instead	of the	space
key like	you	want to
do.	Ther musst	be a
feature in
a comming	version of
this app to inject	whitespace-code	into a
textfile becaue I	won't do
this again.
I am		sorry for
my
bad english but	most people	won't
read this	text	anyway, and you	know what	I wanted
to say.
Ok now	you	can stop
reading	because I	won't	write anything
interesing	here. Trust	me! I	won't
tell	anything about	my life
here		and also	any other
secret. It
seems like you	are
a rebel,	aren't you?
